####################
#******************#
#******************#
#******************#
#*****########*****#
#******************#
#******************#
#******************#
#******************#
#******************#
#******************#
#******************#
#******************#
#########**#########
